1111111111111
1E010000C0001
1000011110011
1P000110010C1
1111111111111