11111111111111111111111111
10C10000000C000C10000000C1
1000010000001100001000C001
1P0C01EM000011C0C01C000001
11111111111111111111111111
11111111111111111111111111
11111M10000100001000011111
11110011110111101111011111
11101011110111101111011111
11111010000100001111011111
11111011110111101111011111
11111011110111101111011111
11111010000100001111011111
11111111111111111111111111