11111111111111111111111
1C000000000000100000001
1000000000000000000C001
110111M000000000C0000M1
11MM000M000000000000001
1111111100011100P000001
10M000000000000M0M00001
10CM0M0000000000M000001
11M1110000111100000C001
10000000000C000000000E1
11111111111111111111111