11111111111111111111111111
10C10000000C000C10000000C1
100001MM00001100001000C001
1P0C01E0000011C0C01C000001
11011111111111111111111111
11011111111111111111111111
11011010000100001000011111
11010011110111101111011111
11001011110111101111011111
11011010000100001000011111
11011011110111101111011111
11011011110111101111011111
11111010000100001111011111
11111111111111111111111111